R 999  999
NO ./assets/textures/purplestone 
SO ./assets/textures/wall_1 
WE ./assets/textures/wall_2 
EA ./assets/textures/wall_3

S ./assets/textures/pika
F 0,102,255
C 64,64,64

   11111111111111111111111111111111111111111111111
   100000000000000000000000000000000000000000000011
   1000000000000000000000000000000000000000000000011
   10000000000000000000000000000000000000000000000011
   100000000000000000000000000000000000000000000000011
   1000000000000000000000000020000000000000000000000011
   10000000000000000000000002020000000000000000000000011
   1000000000000000000000002010200000000000000000000000011
   10000000000E0000000000020111020000000000000000000000011
   10000000000000000000002011 11020000000000000000000000011
   1000000000000000000002011   11020000000000000000000000011
   10000000000000000000002011 11020000000000000000000000011
   1000000000000000000000020111020000000000000000000000011
   100000000000000000000000201020000000000000000000000011 
   100000000000000000000000020200000000000000000000000011
   10000000000000000000000000200000000000000000000000111
   100000000000000000000000000000000000000000000000011
   100000000000000011000000000000000110000000000011111 
   1000000000000000110000000000000001100000000011
   1111111111111111110020000000002001111111111111111111111
    110000000000000000000000000000000000000000000000000011       11111111111111111
    110000000000000000000000000000000000000000000000000011       10000000000000001
    110000000000000000000000000000000000000000000000000011111111110000000000000001
    110000000000000000000000000000000000000000000000000000000000000000000000000001
    110000000000000000000000000000000000000000000000000000000000000000000000000001
    11000000001000010001000001000001000000100000000000011111111110000000000000001
    110000000000000000000000000000000000000000000000000011       1000000000000000111111111
    110000000020000200020000020000020000002000000000000011       1000000000000000000000001
    110000000000000000000000000000000000000000000000000011   11111000000000000000000000001
    110000000010000100010000010000010000001000000000000011   10000000000000000000000000001
    110000000000000000000000000000000000000000000000000011   10000000000000000000000000001
    110000000000000000000000000000000000000000000000000011   11111111111111111111111111111
    11111111111111111111111111111111111111111111111111111

