R 500 900000

S ./texture/pika.xpm

NO ./texture/no_tile.xpm
SO ./texture/so_tile.xpm
WE ./texture/we_tile.xpm
F 105,105,105

EA ./texture/ea_tile.xpm

   
C 38,134,217


         1111111111111111111111111
         1000000000110000000000001
         1011000001110000002000001
         1001000000000000000000001
1111111111110000001110000000N00001
1000000002000000111000111111111111
11110111111111011100000010001
11110111111111011101010010001
110011111111111111111111111111
10000002222222222222222220011
100010000000000000000000000011
1100001111010101111101111000111
11111111 111111 11111111111111